"lsoa11cd","date","lsoa11nm","Rural Urban","Household Composition: All categories: Household composition (alternative child and adult defintions); measures: Value","Household Composition: One person household: Total; measures: Value","Household Composition: One person household: One person aged 65 and over; measures: Value","Household Composition: One person household: One person aged under 65; measures: Value","Household Composition: Other households: Total; measures: Value","Household Composition: Other households: No adults or one adult and one or more children; measures: Value","Household Composition: Other households: One adult aged 16 to 64 and one aged 65 and over and no children or two adults aged 65 and over and no children; measures: Value","Household Composition: Other households: Two adults and one or two children; measures: Value","Household Composition: Other households: Two adults aged 16 to 64 and no children; measures: Value","Household Composition: Other households: Two adults and three or more children; measures: Value","Household Composition: Other households: Three or more adults and one or more children; measures: Value","Household Composition: Other households: Three or more adults and no children; measures: Value"
"E01026791",2011,"Norwich 005A","Total",1475,262,71,191,1213,174,70,250,214,90,111,304
"E01026792",2011,"Norwich 005B","Total",1445,180,80,100,1265,78,166,319,268,106,89,239
"E01026793",2011,"Norwich 005C","Total",1817,102,46,56,1715,202,152,341,186,273,221,340
"E01026794",2011,"Norwich 005D","Total",2021,210,56,154,1811,111,154,434,444,129,186,353
"E01026796",2011,"Norwich 005F","Total",1636,196,88,108,1440,141,162,178,160,134,155,510
"E01026797",2011,"Norwich 001A","Total",2400,341,73,268,2059,138,128,586,554,145,145,363
"E01026798",2011,"Norwich 001B","Total",1533,250,68,182,1283,141,128,271,204,134,200,205
"E01026799",2011,"Norwich 001C","Total",1459,181,42,139,1278,137,110,320,256,89,122,244
"E01026800",2011,"Norwich 001D","Total",1991,364,93,271,1627,200,100,353,318,166,219,271
"E01026801",2011,"Norwich 001E","Total",1560,180,94,86,1380,33,268,299,278,58,117,327
"E01026802",2011,"Norwich 001F","Total",1536,329,88,241,1207,104,168,307,286,74,65,203
"E01026803",2011,"Norwich 004A","Total",1388,212,113,99,1176,130,236,242,184,85,90,209
"E01026804",2011,"Norwich 004B","Total",1429,187,111,76,1242,90,262,228,228,71,157,206
"E01026805",2011,"Norwich 004C","Total",1421,207,120,87,1214,134,256,228,162,107,112,215
"E01026806",2011,"Norwich 004D","Total",1127,131,67,64,996,29,222,203,226,48,65,203
"E01026807",2011,"Norwich 004E","Total",1252,152,69,83,1100,77,80,222,246,180,93,202
"E01026808",2011,"Norwich 004F","Total",1320,154,68,86,1166,176,76,206,164,165,172,207
"E01026809",2011,"Norwich 004G","Total",1483,335,120,215,1148,117,224,238,212,95,85,177
"E01026810",2011,"Norwich 012A","Total",1374,205,127,78,1169,50,276,228,208,61,97,249
"E01026811",2011,"Norwich 012B","Total",1525,243,170,73,1282,12,342,294,224,42,126,242
"E01026812",2011,"Norwich 012C","Total",1425,178,81,97,1247,31,234,297,284,58,140,203
"E01026813",2011,"Norwich 012D","Total",1426,172,125,47,1254,10,352,273,192,47,115,265
"E01026814",2011,"Norwich 012E","Total",1502,203,116,87,1299,74,210,243,218,104,100,350
"E01026815",2011,"Norwich 012F","Total",1450,206,92,114,1244,46,170,350,258,46,104,270
"E01026816",2011,"Norwich 013A","Total",1699,446,134,312,1253,119,114,272,464,47,73,164
"E01026817",2011,"Norwich 013B","Total",1415,297,180,117,1118,103,174,250,254,73,68,196
"E01026818",2011,"Norwich 013C","Total",1462,173,69,104,1289,168,142,281,254,69,167,208
"E01026819",2011,"Norwich 013D","Total",1439,214,54,160,1225,172,96,264,228,119,133,213
"E01026820",2011,"Norwich 013E","Total",1727,272,167,105,1455,149,178,293,220,154,218,243
"E01026821",2011,"Norwich 013F","Total",1542,254,134,120,1288,106,218,291,220,112,78,263
"E01026822",2011,"Norwich 007A","Total",1958,694,219,475,1264,105,176,180,550,5,31,217
"E01026823",2011,"Norwich 007B","Total",1800,597,116,481,1203,65,122,139,574,16,19,268
"E01026824",2011,"Norwich 007C","Total",1471,476,146,330,995,87,116,187,352,46,30,177
"E01026825",2011,"Norwich 007D","Total",1276,359,78,281,917,56,70,206,352,15,29,189
"E01026826",2011,"Norwich 007E","Total",1406,515,174,341,891,109,70,164,320,54,44,130
"E01026827",2011,"Norwich 007F","Total",1501,547,225,322,954,150,150,188,276,44,29,117
"E01026828",2011,"Norwich 002A","Total",1744,162,59,103,1582,195,134,363,210,209,161,310
"E01026829",2011,"Norwich 002B","Total",2063,266,63,203,1797,199,94,423,350,188,159,384
"E01026830",2011,"Norwich 002C","Total",1252,312,112,200,940,117,160,208,246,26,40,143
"E01026831",2011,"Norwich 002D","Total",1242,257,33,224,985,53,56,225,380,56,16,199
"E01026832",2011,"Norwich 002E","Total",1415,99,51,48,1316,166,132,254,138,150,243,233
"E01026833",2011,"Norwich 002F","Total",1382,321,95,226,1061,146,108,326,200,84,88,109
"E01026834",2011,"Norwich 002G","Total",1503,206,98,108,1297,175,140,319,200,90,145,228
"E01026835",2011,"Norwich 009A","Total",1453,236,51,185,1217,85,78,200,252,57,71,474
"E01026836",2011,"Norwich 009B","Total",1566,181,40,141,1385,77,92,303,280,87,95,451
"E01026837",2011,"Norwich 009C","Total",1448,338,89,249,1110,40,96,220,328,91,60,275
"E01026838",2011,"Norwich 009D","Total",1551,171,53,118,1380,64,122,377,300,74,67,376
"E01026839",2011,"Norwich 009E","Total",1592,204,31,173,1388,59,48,273,308,33,37,630
"E01026840",2011,"Norwich 009F","Total",1604,233,42,191,1371,92,88,264,516,20,52,339
"E01026841",2011,"Norwich 003A","Total",1428,272,39,233,1156,78,68,290,470,32,43,175
"E01026842",2011,"Norwich 003B","Total",1628,324,61,263,1304,58,110,334,454,46,56,246
"E01026843",2011,"Norwich 003C","Total",1871,338,113,225,1533,143,160,354,436,53,165,222
"E01026844",2011,"Norwich 003D","Total",1741,314,65,249,1427,200,136,314,358,125,102,192
"E01026845",2011,"Norwich 003E","Total",1561,286,36,250,1275,87,68,326,514,42,58,180
"E01026846",2011,"Norwich 003F","Total",1609,320,64,256,1289,105,66,308,468,39,56,247
"E01026848",2011,"Norwich 015A","Total",1823,512,182,330,1311,218,138,322,304,40,63,226
"E01026849",2011,"Norwich 015B","Total",1677,409,66,343,1268,37,134,298,516,30,62,191
"E01026850",2011,"Norwich 015C","Total",1827,390,80,310,1437,109,134,348,536,66,70,174
"E01026852",2011,"Norwich 011A","Total",1234,228,100,128,1006,24,140,278,272,42,91,159
"E01026853",2011,"Norwich 011B","Total",1746,534,208,326,1212,128,160,231,390,36,45,222
"E01026855",2011,"Norwich 011D","Total",1564,332,102,230,1232,49,118,227,334,51,55,398
"E01026856",2011,"Norwich 011E","Total",1821,306,59,247,1515,102,72,226,460,41,38,576
"E01026857",2011,"Norwich 011F","Total",1515,327,192,135,1188,48,190,207,246,46,100,351
"E01026858",2011,"Norwich 010A","Total",1508,323,161,162,1185,116,198,225,188,72,78,308
"E01026859",2011,"Norwich 010B","Total",1659,154,76,78,1505,189,132,385,194,147,120,338
"E01026860",2011,"Norwich 010C","Total",1098,152,85,67,946,26,174,123,136,73,64,350
"E01026861",2011,"Norwich 010D","Total",1493,105,59,46,1388,110,138,238,144,56,132,570
"E01026862",2011,"Norwich 010E","Total",1302,122,86,36,1180,58,136,202,138,80,167,399
"E01026863",2011,"Norwich 006A","Total",1814,215,80,135,1599,88,146,317,372,42,105,529
"E01026864",2011,"Norwich 006B","Total",1547,169,75,94,1378,160,160,304,296,63,147,248
"E01026865",2011,"Norwich 006C","Total",1949,236,79,157,1713,220,104,383,316,164,165,361
"E01026866",2011,"Norwich 006D","Total",1574,293,68,225,1281,107,146,198,362,66,69,333
"E01026867",2011,"Norwich 006E","Total",1592,136,51,85,1456,138,104,251,152,171,337,303
"E01026868",2011,"Norwich 006F","Total",1623,119,41,78,1504,195,70,289,188,185,218,359
"E01026869",2011,"Norwich 006G","Total",1400,264,63,201,1136,152,132,326,178,101,87,160
"E01033434",2011,"Norwich 011G","Total",1076,311,62,249,765,36,48,157,330,10,40,144
"E01033435",2011,"Norwich 005G","Total",1845,144,21,123,1701,129,50,507,396,118,143,358
"E01033436",2011,"Norwich 005H","Total",1383,187,89,98,1196,102,130,228,236,122,137,241
"E01033437",2011,"Norwich 011H","Total",1334,460,136,324,874,100,100,167,226,48,83,150
"E01033438",2011,"Norwich 014A","Total",1350,557,276,281,793,25,156,124,274,25,45,144
"E01033439",2011,"Norwich 014B","Total",1357,366,42,324,991,42,52,161,470,31,42,193
"E01033440",2011,"Norwich 014C","Total",1070,377,30,347,693,39,32,142,340,30,21,89
"E01033441",2011,"Norwich 014D","Total",1229,428,31,397,801,56,64,125,430,0,17,109
