"lsoa11cd","date","lsoa11nm","Rural Urban","Tenure: All households; measures: Value","Tenure: Owned; measures: Value","Tenure: Owned: Owned outright; measures: Value","Tenure: Owned: Owned with a mortgage or loan; measures: Value","Tenure: Shared ownership (part owned and part rented); measures: Value","Tenure: Social rented; measures: Value","Tenure: Social rented: Rented from council (Local Authority); measures: Value","Tenure: Social rented: Other; measures: Value","Tenure: Private rented; measures: Value","Tenure: Private rented: Private landlord or letting agency; measures: Value","Tenure: Private rented: Other; measures: Value","Tenure: Living rent free; measures: Value"
"E01026791",2011,"Norwich 005A","Total",661,215,84,131,3,345,253,92,89,80,9,9
"E01026792",2011,"Norwich 005B","Total",627,339,151,188,8,213,139,74,63,53,10,4
"E01026793",2011,"Norwich 005C","Total",625,187,77,110,1,358,294,64,71,65,6,8
"E01026794",2011,"Norwich 005D","Total",844,440,137,303,6,269,97,172,125,111,14,4
"E01026796",2011,"Norwich 005F","Total",650,224,118,106,3,283,243,40,129,124,5,11
"E01026797",2011,"Norwich 001A","Total",1070,544,146,398,1,215,130,85,299,273,26,11
"E01026798",2011,"Norwich 001B","Total",670,213,72,141,2,368,324,44,85,81,4,2
"E01026799",2011,"Norwich 001C","Total",626,271,60,211,0,284,254,30,66,58,8,5
"E01026800",2011,"Norwich 001D","Total",901,236,91,145,7,493,422,71,155,149,6,10
"E01026801",2011,"Norwich 001E","Total",684,541,304,237,4,47,43,4,86,85,1,6
"E01026802",2011,"Norwich 001F","Total",785,446,222,224,3,168,98,70,164,150,14,4
"E01026803",2011,"Norwich 004A","Total",638,324,177,147,0,265,235,30,42,35,7,7
"E01026804",2011,"Norwich 004B","Total",633,437,252,185,0,161,158,3,33,27,6,2
"E01026805",2011,"Norwich 004C","Total",639,319,165,154,1,271,250,21,38,32,6,10
"E01026806",2011,"Norwich 004D","Total",508,444,252,192,2,19,18,1,36,27,9,7
"E01026807",2011,"Norwich 004E","Total",523,325,149,176,1,126,118,8,69,64,5,2
"E01026808",2011,"Norwich 004F","Total",516,158,46,112,2,316,307,9,34,31,3,6
"E01026809",2011,"Norwich 004G","Total",762,280,135,145,17,432,414,18,28,25,3,5
"E01026810",2011,"Norwich 012A","Total",635,458,291,167,1,105,65,40,68,64,4,3
"E01026811",2011,"Norwich 012B","Total",723,606,411,195,1,50,42,8,59,51,8,7
"E01026812",2011,"Norwich 012C","Total",639,532,313,219,5,14,12,2,81,76,5,7
"E01026813",2011,"Norwich 012D","Total",635,585,412,173,2,9,7,2,37,35,2,2
"E01026814",2011,"Norwich 012E","Total",653,292,170,122,2,253,248,5,92,81,11,14
"E01026815",2011,"Norwich 012F","Total",648,483,274,209,3,28,13,15,123,114,9,11
"E01026816",2011,"Norwich 013A","Total",934,426,172,254,1,227,113,114,269,250,19,11
"E01026817",2011,"Norwich 013B","Total",706,342,201,141,3,280,215,65,73,66,7,8
"E01026818",2011,"Norwich 013C","Total",626,270,119,151,1,312,295,17,35,29,6,8
"E01026819",2011,"Norwich 013D","Total",625,179,68,111,1,389,382,7,49,40,9,7
"E01026820",2011,"Norwich 013E","Total",755,294,141,153,0,400,360,40,52,45,7,9
"E01026821",2011,"Norwich 013F","Total",712,330,162,168,1,332,326,6,39,30,9,10
"E01026822",2011,"Norwich 007A","Total",1228,366,227,139,2,506,200,306,335,317,18,19
"E01026823",2011,"Norwich 007B","Total",1099,376,188,188,10,284,187,97,414,394,20,15
"E01026824",2011,"Norwich 007C","Total",868,212,103,109,4,473,449,24,164,149,15,15
"E01026825",2011,"Norwich 007D","Total",718,239,85,154,3,245,192,53,224,202,22,7
"E01026826",2011,"Norwich 007E","Total",864,144,64,80,5,495,289,206,212,198,14,8
"E01026827",2011,"Norwich 007F","Total",931,148,62,86,1,646,491,155,123,109,14,13
"E01026828",2011,"Norwich 002A","Total",664,220,71,149,1,393,351,42,45,42,3,5
"E01026829",2011,"Norwich 002B","Total",857,271,82,189,26,368,314,54,185,175,10,7
"E01026830",2011,"Norwich 002C","Total",682,216,92,124,0,336,271,65,123,117,6,7
"E01026831",2011,"Norwich 002D","Total",632,332,114,218,4,70,40,30,221,205,16,5
"E01026832",2011,"Norwich 002E","Total",498,180,64,116,2,290,270,20,24,21,3,2
"E01026833",2011,"Norwich 002F","Total",696,89,30,59,16,553,478,75,34,30,4,4
"E01026834",2011,"Norwich 002G","Total",644,234,98,136,2,340,253,87,63,57,6,5
"E01026835",2011,"Norwich 009A","Total",643,328,160,168,0,42,8,34,267,255,12,6
"E01026836",2011,"Norwich 009B","Total",646,402,199,203,4,13,8,5,225,215,10,2
"E01026837",2011,"Norwich 009C","Total",735,346,172,174,2,103,42,61,274,260,14,10
"E01026838",2011,"Norwich 009D","Total",645,428,211,217,2,8,2,6,199,189,10,8
"E01026839",2011,"Norwich 009E","Total",668,313,127,186,0,18,7,11,328,306,22,9
"E01026840",2011,"Norwich 009F","Total",759,431,190,241,3,39,26,13,281,263,18,5
"E01026841",2011,"Norwich 003A","Total",726,390,123,267,0,43,32,11,286,268,18,7
"E01026842",2011,"Norwich 003B","Total",818,480,205,275,4,34,31,3,295,278,17,5
"E01026843",2011,"Norwich 003C","Total",902,406,154,252,1,308,291,17,181,165,16,6
"E01026844",2011,"Norwich 003D","Total",823,368,131,237,17,289,267,22,140,131,9,9
"E01026845",2011,"Norwich 003E","Total",786,429,112,317,10,35,20,15,308,287,21,4
"E01026846",2011,"Norwich 003F","Total",811,396,132,264,2,79,56,23,324,299,25,10
"E01026848",2011,"Norwich 015A","Total",1015,204,92,112,2,678,454,224,125,114,11,6
"E01026849",2011,"Norwich 015B","Total",913,463,224,239,4,63,20,43,370,359,11,13
"E01026850",2011,"Norwich 015C","Total",952,484,214,270,3,168,134,34,287,267,20,10
"E01026852",2011,"Norwich 011A","Total",598,476,295,181,3,17,12,5,98,97,1,4
"E01026853",2011,"Norwich 011B","Total",1011,291,144,147,4,511,391,120,191,174,17,14
"E01026855",2011,"Norwich 011D","Total",773,399,244,155,2,49,43,6,315,297,18,8
"E01026856",2011,"Norwich 011E","Total",847,380,178,202,4,76,64,12,382,357,25,5
"E01026857",2011,"Norwich 011F","Total",751,393,235,158,3,159,75,84,184,174,10,12
"E01026858",2011,"Norwich 010A","Total",745,190,107,83,1,432,359,73,108,98,10,14
"E01026859",2011,"Norwich 010B","Total",640,268,168,100,56,241,51,190,73,63,10,2
"E01026860",2011,"Norwich 010C","Total",470,221,157,64,2,152,137,15,90,69,21,5
"E01026861",2011,"Norwich 010D","Total",549,162,86,76,4,269,168,101,104,88,16,10
"E01026862",2011,"Norwich 010E","Total",497,235,115,120,3,191,112,79,61,55,6,7
"E01026863",2011,"Norwich 006A","Total",771,415,202,213,4,130,97,33,206,186,20,16
"E01026864",2011,"Norwich 006B","Total",657,391,170,221,3,168,107,61,85,73,12,10
"E01026865",2011,"Norwich 006C","Total",805,173,59,114,17,463,401,62,144,132,12,8
"E01026866",2011,"Norwich 006D","Total",767,390,177,213,9,159,127,32,199,174,25,10
"E01026867",2011,"Norwich 006E","Total",562,170,74,96,21,310,297,13,52,48,4,9
"E01026868",2011,"Norwich 006F","Total",565,134,61,73,13,331,257,74,84,77,7,3
"E01026869",2011,"Norwich 006G","Total",657,179,74,105,0,436,413,23,41,36,5,1
"E01033434",2011,"Norwich 011G","Total",615,271,99,172,20,75,71,4,243,222,21,6
"E01033435",2011,"Norwich 005G","Total",705,308,67,241,16,134,47,87,239,224,15,8
"E01033436",2011,"Norwich 005H","Total",596,193,92,101,0,319,229,90,79,75,4,5
"E01033437",2011,"Norwich 011H","Total",786,154,81,73,11,480,451,29,122,113,9,19
"E01033438",2011,"Norwich 014A","Total",878,312,225,87,4,227,31,196,314,277,37,21
"E01033439",2011,"Norwich 014B","Total",763,318,114,204,3,41,31,10,393,381,12,8
"E01033440",2011,"Norwich 014C","Total",662,139,53,86,14,280,138,142,221,215,6,8
"E01033441",2011,"Norwich 014D","Total",773,245,88,157,4,101,55,46,415,394,21,8
